2222222222222222222222222222222222222222
2333330000000000550000000000000000000002
2333330000000000550000005500000000000002
2333330000010000000000555505500000000002
2000000000020000000000550005500000000002
2000000000020000000000000000000000000002
2000000000020000000000000000000000000002
2000000002220000000000000000000000000002
2000000002000000000000000000000000000002
2000000002000000000000000000000000000002
2000000000000000000000000000000000000002
2000000000000000000000000000000000000002
2000011100101000111000101000111000111002
2000013100101000010000101000131000101002
2000011100111000010000111000131000101002
2000010000010000010000101000131000101002
2000010000010000010000101000111000101002
2000000000000000000000000000000000000002
2000000000000002222220010000000000000002
2000000000000002212221100000000000000002
2000000000000002222220010000000000000002
2000000000000002120000000000000000000002
2000000000000002220000002222100000000002
2000000000000002220000002000000000000002
2000000000002222120000222000000000000002
2000000000002122220000000000000000000002
2000000000002220000000000000000000333332
2000000000002120000000000000000000333332
2000000000002220000000000000000000333332
2222222222222222222222222222222222222222
