2222222222222222222222222222222222222222
2000000000000021212000000000000000000002
2000000000000021212000000000000000000002
2000002000000021112000000000000000000002
2000002000000000200000000000000000000002
2000000000000000200000000000000000000002
2000000000010000100000000200000000000002
2000100000010000000000000200000000000002
2000010100000000000000000000020000000002
2000000200000000000000000000020000000002
2000000200000000000000000000000000000002
2000021112000000000000000200000000000002
2000021212000000000000000200000000000002
2000021212000000000000000000000000000002
2000021212000000000000000000000000000002
2000021112000000000000000010000000000002
2000000000000000000000000020000000000002
2000000000000000000000000020000000000002
2000000000000000000000002111200000000002
2000000000000000000000002121200000000002
2000000000000000000000002121200000000002
2000000000000000000000002121200000000002
2000000000000000000000002111200000000002
2000000000000000000000000000000000000002
2300000000000000000000000000000000000032
2330000000000000000005500000000000000332
2333333333333333553335533333333333333332
2333333333333333553553333333333333333332
2333333333333333333553333333333333333332
2222222222222222222222222222222222222222
