4444444444444444444444444444444444444444
4444444444444441111111111111111111444444
4444444444444413333333333333333331144444
4444444444444413330000000000000333314444
4444444444444100000000000000000000001444
4444442444444100000000000000000000000144
4444421244441000000000000000000000000144
4444211124410000000000000000000000000014
4442111112410000000000000000000000000014
4442112112410000000000000000000000000014
4442111115500000000000000000000000000014
4442111115500000000000000000000000000014
4442112112410000000000022000000000000014
4442111112410000000000022000000000000014
4442111112410000000000110000000011000014
4444222224410000000000110000000011000014
4444444444100000000000000000002220000014
4444444444100000000000000000112220000014
4444444444100000000000000000112220000014
4444444441000000000000000000002220000014
4444444410000000000000000000002220000014
4444444100000000000000000000000000000014
4444441000000000000000000000000000000144
4444410000000000000000000000000000001444
4444410000000000000000000000000000014444
4444410000000000000000000000000000144444
4444410000000000000000000000000001444444
4444441111000000000000000000000014444444
4444444444111111111111111111111144444444
4444444444444444444444444444444444444444

уровень остров
